"lang"
{
"Language"	"Estonian"
"Tokens"
{
"#lang_danish"	"taani"
"[english]#lang_danish"	"Danish"
"#lang_dutch"	"hollandi"
"[english]#lang_dutch"	"Dutch"
"#lang_english"	"inglise"
"[english]#lang_english"	"English"
"#lang_finnish"	"soome"
"[english]#lang_finnish"	"Finnish"
"#lang_french"	"prantsuse"
"[english]#lang_french"	"French"
"#lang_italian"	"itaalia"
"[english]#lang_italian"	"Italian"
"#lang_german"	"german"
"[english]#lang_german"	"German"
"#lang_spanish"	"hispaania"
"[english]#lang_spanish"	"Spanish"
"#lang_schinese"	"lihtsustatud hiina"
"[english]#lang_schinese"	"Simplified Chinese"
"#lang_korean"	"korea"
"[english]#lang_korean"	"Korean"
"#lang_koreana"	"korea"
"[english]#lang_koreana"	"Korean"
"#lang_norwegian"	"norra"
"[english]#lang_norwegian"	"Norwegian"
"#lang_tchinese"	"traditsiooniline hiina"
"[english]#lang_tchinese"	"Traditional Chinese"
"#lang_japanese"	"jaapani"
"[english]#lang_japanese"	"Japanese"
"#lang_russian"	"vene"
"[english]#lang_russian"	"Russian"
"#lang_thai"	"tai"
"[english]#lang_thai"	"Thai"
"#lang_swedish"	"rootsi"
"[english]#lang_swedish"	"Swedish"
"#lang_portuguese"	"xxxxxxxxxxxxxxxxxxxx"
"[english]#lang_portuguese"	"Portuguese"
"#lang_polish"	"portugali"
"[english]#lang_polish"	"Polish"
"#lang_slovakian"	"poola"
"[english]#lang_slovakian"	"Slovakian"
"#lang_hungarian"	"ungari"
"[english]#lang_hungarian"	"Hungarian"
"#lang_czech"	"tšehhi"
"[english]#lang_czech"	"Czech"
"#language_selection_english"	"English (inglise)"
"[english]#language_selection_english"	"English"
"#language_selection_spanish"	"Español (hispaania)"
"[english]#language_selection_spanish"	"Español (Spanish)"
"#language_selection_french"	"Français (prantsuse)"
"[english]#language_selection_french"	"Français (French)"
"#language_selection_italian"	"Italiano (itaalia)"
"[english]#language_selection_italian"	"Italiano (Italian)"
"#language_selection_german"	"Deutsch (saksa)"
"[english]#language_selection_german"	"Deutsch (German)"
"#language_selection_koreana"	"한국어 (korea)"
"[english]#language_selection_koreana"	"한국어 (Korean)"
"#language_selection_schinese"	"简体中文 (lihtsustatud hiina)"
"[english]#language_selection_schinese"	"简体中文 (Simplified Chinese)"
"#language_selection_tchinese"	"繁體中文 (traditsiooniline hiina)"
"[english]#language_selection_tchinese"	"繁體中文 (Traditional Chinese)"
"#language_selection_russian"	"Русский (vene)"
"[english]#language_selection_russian"	"Русский (Russian)"
"#language_selection_thai"	"ไทย (tai)"
"[english]#language_selection_thai"	"ไทย (Thai)"
"#language_selection_japanese"	"日本語 (jaapani)"
"[english]#language_selection_japanese"	"日本語 (Japanese)"
"#language_selection_portuguese"	"Português (portugali)"
"[english]#language_selection_portuguese"	"Português (Portuguese)"
"#language_selection_polish"	"Polski (poola)"
"[english]#language_selection_polish"	"Polski (Polish)"
"#language_selection_danish"	"Dansk (taani)"
"[english]#language_selection_danish"	"Dansk (Danish)"
"#language_selection_dutch"	"Nederlands (hollandi)"
"[english]#language_selection_dutch"	"Nederlands (Dutch)"
"#language_selection_finnish"	"Suomi (soome)"
"[english]#language_selection_finnish"	"Suomi (Finnish)"
"#language_selection_norwegian"	"Norsk (norra)"
"[english]#language_selection_norwegian"	"Norsk (Norwegian)"
"#language_selection_swedish"	"Svenska (rootsi)"
"[english]#language_selection_swedish"	"Svenska (Swedish)"
"#language_selection_czech"	"čeština (tšehhi)"
"[english]#language_selection_czech"	"čeština (Czech)"
"#language_selection_hungarian"	"Magyar (ungari)"
"[english]#language_selection_hungarian"	"Magyar (Hungarian)"
"#language_selection_romanian"	"Română (rumeenia)"
"[english]#language_selection_romanian"	"Română (Romanian)"
"#lang_romanian"	"rumeenia"
"[english]#lang_romanian"	"Romanian"
"#language_selection_turkish"	"Türkçe (türgi)"
"[english]#language_selection_turkish"	"Türkçe (Turkish)"
"#lang_brazilian"	"Brasiilia portugali"
"[english]#lang_brazilian"	"Portuguese-Brazil"
"#lang_bulgarian"	"bulgaaria"
"[english]#lang_bulgarian"	"Bulgarian"
"#lang_turkish"	"türgi"
"[english]#lang_turkish"	"Turkish"
"#language_selection_brazilian"	"Português-Brasil (Brasiilia portugali)"
"[english]#language_selection_brazilian"	"Português-Brasil (Portuguese-Brazil)"
"#language_selection_bulgarian"	"Български (bulgaaria)"
"[english]#language_selection_bulgarian"	"Български (Bulgarian)"
"#lang_greek"	"kreeka"
"[english]#lang_greek"	"Greek"
"#language_selection_greek"	"Ελληνικά (kreeka)"
"[english]#language_selection_greek"	"Ελληνικά (Greek)"
"AppHub_Nav_All"	"Kõik"
"[english]AppHub_Nav_All"	"All"
"AppHub_Nav_Discussions"	"Arutelud"
"[english]AppHub_Nav_Discussions"	"Discussions"
"AppHub_Nav_WorkshopItems"	"Töökoda"
"[english]AppHub_Nav_WorkshopItems"	"Workshop"
"AppHub_Nav_Videos"	"Videod"
"[english]AppHub_Nav_Videos"	"Videos"
"AppHub_Nav_Screenshots"	"Kuvatõmmised"
"[english]AppHub_Nav_Screenshots"	"Screenshots"
"AppHub_Nav_News"	"Uudised"
"[english]AppHub_Nav_News"	"News"
"AppHub_Nav_Art"	"xxxxxxxxxxxxxxxxxxxx"
"[english]AppHub_Nav_Art"	"Artwork"
"AppHub_Nav_Recommendations"	"Soovitused"
"[english]AppHub_Nav_Recommendations"	"Recommendations"
"AppHub_Nav_OfficialGroup"	"Ametlik grupp"
"[english]AppHub_Nav_OfficialGroup"	"Official Group"
"AppHub_Nav_FriendActivity"	"Sõprade tegevused"
"[english]AppHub_Nav_FriendActivity"	"Friend Activity"
"AppHub_Community"	"xxxxxxxxxxxxxxxxxxxx"
"[english]AppHub_Community"	"Community Hub"
"AppHub_Store"	"Poe lehekülg"
"[english]AppHub_Store"	"Store Page"
"AppHub_UserPlaytime"	"%1$s tundi mängitud"
"[english]AppHub_UserPlaytime"	"%1$s hours played"
"AppHub_NumInApp"	"%1$s mängu sees"
"[english]AppHub_NumInApp"	"%1$s In-Game"
"AppHub_NumInChat"	"%1$s grupivestluses"
"[english]AppHub_NumInChat"	"%1$s in Group Chat"
"AppHub_JoinChat"	"Liitu vestlusega"
"[english]AppHub_JoinChat"	"Join Chat"
"AppHub_PlayNow"	"Mängi nüüd"
"[english]AppHub_PlayNow"	"Play Now"
"AppHub_InstallSteam"	"Installi Steam"
"[english]AppHub_InstallSteam"	"Install Steam"
"AppHub_FriendsWhoPlay"	"xxxxxxxxxxxxxxxxxxxx"
"[english]AppHub_FriendsWhoPlay"	"%1$s Friends who play"
"AppHub_NoFriendsWhoPlayedRecentlyRecommend"	"xxxxxxxxxxxxxxxxxxxx"
"[english]AppHub_NoFriendsWhoPlayedRecentlyRecommend"	"Tell them why they should."
"AppHub_NoFriendsWhoPlayedRecently"	"xxxxxxxxxxxxxxxxxxxx"
"[english]AppHub_NoFriendsWhoPlayedRecently"	"None of your friends have played this game recently."
"AppHub_VisitStore"	"Külasta poe lehekülge"
"[english]AppHub_VisitStore"	"Visit the Store Page"
"AppHub_ContentType_Item"	"xxxxxxxxxxxxxxxxxxxx"
"[english]AppHub_ContentType_Item"	"Workshop Item"
"AppHub_ContentType_Collection"	"xxxxxxxxxxxxxxxxxxxx"
"[english]AppHub_ContentType_Collection"	"Workshop Collection"
"AppHub_ContentType_Art"	"xxxxxxxxxxxxxxxxxxxx"
"[english]AppHub_ContentType_Art"	"Artwork"
"AppHub_ContentType_Screenshot"	"xxxxxxxxxxxxxxxxxxxx"
"[english]AppHub_ContentType_Screenshot"	"Screenshot"
"AppHub_ContentType_Video"	"xxxxxxxxxxxxxxxxxxxx"
"[english]AppHub_ContentType_Video"	"Video"
"AppHub_ContentType_Announcement"	"xxxxxxxxxxxxxxxxxxxx"
"[english]AppHub_ContentType_Announcement"	"Official News"
"AppHub_ContentType_News"	"xxxxxxxxxxxxxxxxxxxx"
"[english]AppHub_ContentType_News"	"News"
"AppHub_ContentType_Discussion"	"xxxxxxxxxxxxxxxxxxxx"
"[english]AppHub_ContentType_Discussion"	"Discussion"
"AppHub_ViewDiscussion"	"xxxxxxxxxxxxxxxxxxxx"
"[english]AppHub_ViewDiscussion"	"Read at %1$s"
"AppHub_Discussion_Posted_JustNow"	"xxxxxxxxxxxxxxxxxxxx"
"[english]AppHub_Discussion_Posted_JustNow"	"Just now"
"AppHub_Discussion_Posted_MinutesAgo"	"xxxxxxxxxxxxxxxxxxxx"
"[english]AppHub_Discussion_Posted_MinutesAgo"	"%s minutes ago"
"AppHub_Discussion_Posted_OneHourAgo"	"xxxxxxxxxxxxxxxxxxxx"
"[english]AppHub_Discussion_Posted_OneHourAgo"	"1 hour ago"
"AppHub_Discussion_Posted_HoursAgo"	"xxxxxxxxxxxxxxxxxxxx"
"[english]AppHub_Discussion_Posted_HoursAgo"	"%s hours ago"
"AppHub_DiscussionType_Workshop"	"xxxxxxxxxxxxxxxxxxxx"
"[english]AppHub_DiscussionType_Workshop"	"Workshop Discussions"
"AppHub_Card_NumRatings"	"xxxxxxxxxxxxxxxxxxxx"
"[english]AppHub_Card_NumRatings"	"%1$s ratings"
"AppHub_CardLink_Items"	"xxxxxxxxxxxxxxxxxxxx"
"[english]AppHub_CardLink_Items"	"View Steam Workshop items"
"AppHub_CardLink_Collections"	"xxxxxxxxxxxxxxxxxxxx"
"[english]AppHub_CardLink_Collections"	"View Steam Workshop collections"
"AppHub_CardLink_Art"	"xxxxxxxxxxxxxxxxxxxx"
"[english]AppHub_CardLink_Art"	"View artwork"
"AppHub_CardLink_Screenshots"	"xxxxxxxxxxxxxxxxxxxx"
"[english]AppHub_CardLink_Screenshots"	"View screenshots"
"AppHub_CardLink_Videos"	"xxxxxxxxxxxxxxxxxxxx"
"[english]AppHub_CardLink_Videos"	"View videos"
"AppHub_CardLink_Announcements"	"xxxxxxxxxxxxxxxxxxxx"
"[english]AppHub_CardLink_Announcements"	"View all official news"
"AppHub_ContentType_Announcement_Author"	"xxxxxxxxxxxxxxxxxxxx"
"[english]AppHub_ContentType_Announcement_Author"	"Shared by: "
"AppHub_ViewStats"	"xxxxxxxxxxxxxxxxxxxx"
"[english]AppHub_ViewStats"	"View Stats"
"AppHub_Nav_Announcements"	"xxxxxxxxxxxxxxxxxxxx"
"[english]AppHub_Nav_Announcements"	"Announcements"
"AppHub_Nav_Guides"	"xxxxxxxxxxxxxxxxxxxx"
"[english]AppHub_Nav_Guides"	"Guides"
"AppHub_ContentType_Guide"	"xxxxxxxxxxxxxxxxxxxx"
"[english]AppHub_ContentType_Guide"	"Guide"
"AppHub_CardLink_Guides"	"xxxxxxxxxxxxxxxxxxxx"
"[english]AppHub_CardLink_Guides"	"View all guides"
"AppHub_ContentType_GreenlightGame"	"xxxxxxxxxxxxxxxxxxxx"
"[english]AppHub_ContentType_GreenlightGame"	"Game"
"AppHub_ContentType_GreenlightSoftware"	"xxxxxxxxxxxxxxxxxxxx"
"[english]AppHub_ContentType_GreenlightSoftware"	"Software"
"AppHub_ContentType_GreenlightConcept"	"xxxxxxxxxxxxxxxxxxxx"
"[english]AppHub_ContentType_GreenlightConcept"	"Concept"
"AppHub_CardLink_Greenlight"	"xxxxxxxxxxxxxxxxxxxx"
"[english]AppHub_CardLink_Greenlight"	"View all Greenlight items"
"AppHub_ContentType_IntegratedGuide"	"xxxxxxxxxxxxxxxxxxxx"
"[english]AppHub_ContentType_IntegratedGuide"	"Integrated Guide"
"AppHub_FriendWhoPlays"	"xxxxxxxxxxxxxxxxxxxx"
"[english]AppHub_FriendWhoPlays"	"%1$s Friend who plays"
"#CommunityNav_Home"	"xxxxxxxxxxxxxxxxxxxx"
"[english]#CommunityNav_Home"	"Home"
"#CommunityNav_GameHubs"	"xxxxxxxxxxxxxxxxxxxx"
"[english]#CommunityNav_GameHubs"	"Game Hubs"
"#CommunityNav_Discussions"	"xxxxxxxxxxxxxxxxxxxx"
"[english]#CommunityNav_Discussions"	"DISCUSSIONS"
"#CommunityNav_Workshop"	"xxxxxxxxxxxxxxxxxxxx"
"[english]#CommunityNav_Workshop"	"Workshop"
"#CommunityNav_Greenlight"	"xxxxxxxxxxxxxxxxxxxx"
"[english]#CommunityNav_Greenlight"	"Greenlight"
"#CommunityNav_Market"	"xxxxxxxxxxxxxxxxxxxx"
"[english]#CommunityNav_Market"	"Market"
"#CommunityNav_ModeratorsTools"	"xxxxxxxxxxxxxxxxxxxx"
"[english]#CommunityNav_ModeratorsTools"	"Moderator Tools"
"#CommunityNav_Activity"	"xxxxxxxxxxxxxxxxxxxx"
"[english]#CommunityNav_Activity"	"Activity"
"#CommunityNav_Profile"	"xxxxxxxxxxxxxxxxxxxx"
"[english]#CommunityNav_Profile"	"Profile"
"#CommunityNav_Friends"	"xxxxxxxxxxxxxxxxxxxx"
"[english]#CommunityNav_Friends"	"Friends"
"#CommunityNav_Groups"	"xxxxxxxxxxxxxxxxxxxx"
"[english]#CommunityNav_Groups"	"Groups"
"#CommunityNav_Content"	"xxxxxxxxxxxxxxxxxxxx"
"[english]#CommunityNav_Content"	"Content"
"#CommunityNav_Badges"	"xxxxxxxxxxxxxxxxxxxx"
"[english]#CommunityNav_Badges"	"Badges"
"#CommunityNav_Inventory"	"xxxxxxxxxxxxxxxxxxxx"
"[english]#CommunityNav_Inventory"	"Inventory"
"#StoreNav_Featured"	"xxxxxxxxxxxxxxxxxxxx"
"[english]#StoreNav_Featured"	"Featured"
"#StoreNav_News"	"xxxxxxxxxxxxxxxxxxxx"
"[english]#StoreNav_News"	"News"
"#StoreNav_Recommended"	"xxxxxxxxxxxxxxxxxxxx"
"[english]#StoreNav_Recommended"	"Recommended"
"#StoreNav_Wishlist"	"xxxxxxxxxxxxxxxxxxxx"
"[english]#StoreNav_Wishlist"	"Wishlist"
"#m_ext_new"	"xxxxxxxxxxxxxxxxxxxx"
"[english]#m_ext_new"	"NEW"
"AppHub_Nav_Admin"	"xxxxxxxxxxxxxxxxxxxx"
"[english]AppHub_Nav_Admin"	"Admin"
"#CommunityNav_DMCA"	"xxxxxxxxxxxxxxxxxxxx"
"[english]#CommunityNav_DMCA"	"DMCA Notices"
"Shared_ButtonOK"	"xxxxxxxxxxxxxxxxxxxx"
"[english]Shared_ButtonOK"	"OK"
"Shared_ButtonCancel"	"xxxxxxxxxxxxxxxxxxxx"
"[english]Shared_ButtonCancel"	"Cancel"
"AppHub_NormallyHidden"	"xxxxxxxxxxxxxxxxxxxx"
"[english]AppHub_NormallyHidden"	"This Community Hub is hidden to the public, but since you are an Admin, it is visible to you. You can pre-seed the Community Hub with content that will be visible when it goes live."
"#steam_inbox_item"	"xxxxxxxxxxxxxxxxxxxx"
"[english]#steam_inbox_item"	"1 new item in your inventory"
"#steam_inbox_items"	"xxxxxxxxxxxxxxxxxxxx"
"[english]#steam_inbox_items"	"%s new items in your inventory"
"#steam_inbox_invite"	"xxxxxxxxxxxxxxxxxxxx"
"[english]#steam_inbox_invite"	"1 new invite"
"#steam_inbox_invites"	"xxxxxxxxxxxxxxxxxxxx"
"[english]#steam_inbox_invites"	"%s new invites"
"#steam_inbox_gift"	"xxxxxxxxxxxxxxxxxxxx"
"[english]#steam_inbox_gift"	"1 new gift"
"#steam_inbox_gifts"	"xxxxxxxxxxxxxxxxxxxx"
"[english]#steam_inbox_gifts"	"%s new gifts"
"#steam_inbox_commentnotification"	"xxxxxxxxxxxxxxxxxxxx"
"[english]#steam_inbox_commentnotification"	"1 new comment"
"#steam_inbox_commentnotifications"	"xxxxxxxxxxxxxxxxxxxx"
"[english]#steam_inbox_commentnotifications"	"%s new comments"
"#steam_inbox_offlinemessage"	"xxxxxxxxxxxxxxxxxxxx"
"[english]#steam_inbox_offlinemessage"	"1 unread chat message"
"#steam_inbox_offlinemessages"	"xxxxxxxxxxxxxxxxxxxx"
"[english]#steam_inbox_offlinemessages"	"%s unread chat messages"
"#steam_inbox_tradeoffers"	"xxxxxxxxxxxxxxxxxxxx"
"[english]#steam_inbox_tradeoffers"	"1 new trade notification"
"#steam_inbox_tradeoffers_plural"	"xxxxxxxxxxxxxxxxxxxx"
"[english]#steam_inbox_tradeoffers_plural"	"%s new trade notifications"
"Shared_ButtonYes"	"xxxxxxxxxxxxxxxxxxxx"
"[english]Shared_ButtonYes"	"Yes"
"Shared_ButtonNo"	"xxxxxxxxxxxxxxxxxxxx"
"[english]Shared_ButtonNo"	"No"
"#Economy_SteamContext_Gifts"	"xxxxxxxxxxxxxxxxxxxx"
"[english]#Economy_SteamContext_Gifts"	"Gifts"
"#Economy_SteamContext_Coupons"	"xxxxxxxxxxxxxxxxxxxx"
"[english]#Economy_SteamContext_Coupons"	"Coupons"
"#Economy_SteamContext_Community"	"xxxxxxxxxxxxxxxxxxxx"
"[english]#Economy_SteamContext_Community"	"Community"
"#date_month_1"	"xxxxxxxxxxxxxxxxxxxx"
"[english]#date_month_1"	"January"
"#date_month_2"	"xxxxxxxxxxxxxxxxxxxx"
"[english]#date_month_2"	"February"
"#date_month_3"	"xxxxxxxxxxxxxxxxxxxx"
"[english]#date_month_3"	"March"
"#date_month_4"	"xxxxxxxxxxxxxxxxxxxx"
"[english]#date_month_4"	"April"
"#date_month_5"	"xxxxxxxxxxxxxxxxxxxx"
"[english]#date_month_5"	"May"
"#date_month_6"	"xxxxxxxxxxxxxxxxxxxx"
"[english]#date_month_6"	"June"
"#date_month_7"	"xxxxxxxxxxxxxxxxxxxx"
"[english]#date_month_7"	"July"
"#date_month_8"	"xxxxxxxxxxxxxxxxxxxx"
"[english]#date_month_8"	"August"
"#date_month_9"	"xxxxxxxxxxxxxxxxxxxx"
"[english]#date_month_9"	"September"
"#date_month_10"	"xxxxxxxxxxxxxxxxxxxx"
"[english]#date_month_10"	"October"
"#date_month_11"	"xxxxxxxxxxxxxxxxxxxx"
"[english]#date_month_11"	"November"
"#date_month_12"	"xxxxxxxxxxxxxxxxxxxx"
"[english]#date_month_12"	"December"
"#date_shortmonth_1"	"xxxxxxxxxxxxxxxxxxxx"
"[english]#date_shortmonth_1"	"Jan"
"#date_shortmonth_2"	"xxxxxxxxxxxxxxxxxxxx"
"[english]#date_shortmonth_2"	"Feb"
"#date_shortmonth_3"	"xxxxxxxxxxxxxxxxxxxx"
"[english]#date_shortmonth_3"	"Mar"
"#date_shortmonth_4"	"xxxxxxxxxxxxxxxxxxxx"
"[english]#date_shortmonth_4"	"Apr"
"#date_shortmonth_5"	"xxxxxxxxxxxxxxxxxxxx"
"[english]#date_shortmonth_5"	"May"
"#date_shortmonth_6"	"xxxxxxxxxxxxxxxxxxxx"
"[english]#date_shortmonth_6"	"Jun"
"#date_shortmonth_7"	"xxxxxxxxxxxxxxxxxxxx"
"[english]#date_shortmonth_7"	"Jul"
"#date_shortmonth_8"	"xxxxxxxxxxxxxxxxxxxx"
"[english]#date_shortmonth_8"	"Aug"
"#date_shortmonth_9"	"xxxxxxxxxxxxxxxxxxxx"
"[english]#date_shortmonth_9"	"Sep"
"#date_shortmonth_10"	"xxxxxxxxxxxxxxxxxxxx"
"[english]#date_shortmonth_10"	"Oct"
"#date_shortmonth_11"	"xxxxxxxxxxxxxxxxxxxx"
"[english]#date_shortmonth_11"	"Nov"
"#date_shortmonth_12"	"xxxxxxxxxxxxxxxxxxxx"
"[english]#date_shortmonth_12"	"Dec"
"#date_timeofday_ampm"	"xxxxxxxxxxxxxxxxxxxx"
"[english]#date_timeofday_ampm"	"%1$s:%2$s%3$s"
"#date_timeofday_24h"	"xxxxxxxxxxxxxxxxxxxx"
"[english]#date_timeofday_24h"	"%1$s:%2$s"
"#date_time_am"	"xxxxxxxxxxxxxxxxxxxx"
"[english]#date_time_am"	"am"
"#date_time_pm"	"xxxxxxxxxxxxxxxxxxxx"
"[english]#date_time_pm"	"pm"
"#date_date_at_time"	"xxxxxxxxxxxxxxxxxxxx"
"[english]#date_date_at_time"	"%1$s @ %2$s"
"#date_day_shortmonth_year"	"xxxxxxxxxxxxxxxxxxxx"
"[english]#date_day_shortmonth_year"	"%1$s %2$s, %3$s"
"#date_day_shortmonth"	"xxxxxxxxxxxxxxxxxxxx"
"[english]#date_day_shortmonth"	"%1$s %2$s"
"#date_day_longmonth_year"	"xxxxxxxxxxxxxxxxxxxx"
"[english]#date_day_longmonth_year"	"%1$s %2$s, %3$s"
"#steam_inbox_asyncgame"	"xxxxxxxxxxxxxxxxxxxx"
"[english]#steam_inbox_asyncgame"	"1 turn waiting"
"#steam_inbox_asyncgame_plural"	"xxxxxxxxxxxxxxxxxxxx"
"[english]#steam_inbox_asyncgame_plural"	"%s new turns waiting"
"#steam_inbox_asyncgameinvite"	"xxxxxxxxxxxxxxxxxxxx"
"[english]#steam_inbox_asyncgameinvite"	"1 new game invite"
"#steam_inbox_asyncgameinvite_plural"	"xxxxxxxxxxxxxxxxxxxx"
"[english]#steam_inbox_asyncgameinvite_plural"	"%s new game invites"
"AppHub_Nav_Reviews"	"xxxxxxxxxxxxxxxxxxxx"
"[english]AppHub_Nav_Reviews"	"Reviews"
"AppHub_ContentType_UserReview"	"xxxxxxxxxxxxxxxxxxxx"
"[english]AppHub_ContentType_UserReview"	"User Review"
"AppHub_CardLink_Reviews"	"xxxxxxxxxxxxxxxxxxxx"
"[english]AppHub_CardLink_Reviews"	"View all reviews"
"#UserReviews_Error"	"xxxxxxxxxxxxxxxxxxxx"
"[english]#UserReviews_Error"	"Error"
"#UserReviews_Error_Text"	"xxxxxxxxxxxxxxxxxxxx"
"[english]#UserReviews_Error_Text"	"There was an error trying to process your request: "
"#UserReviews_Report_Title"	"xxxxxxxxxxxxxxxxxxxx"
"[english]#UserReviews_Report_Title"	"Report Review"
"#UserReviews_Report_Text"	"xxxxxxxxxxxxxxxxxxxx"
"[english]#UserReviews_Report_Text"	"Please enter the reason why you are reporting this review for violating the Steam Terms of Service or Online Conduct Rules. This cannot be undone."
"#UserReviews_RatingStats"	"xxxxxxxxxxxxxxxxxxxx"
"[english]#UserReviews_RatingStats"	"1 person found this review helpful"
"#UserReviews_RatingStats_none"	"xxxxxxxxxxxxxxxxxxxx"
"[english]#UserReviews_RatingStats_none"	"No ratings yet"
"#UserReviews_RatingStats_plural"	"xxxxxxxxxxxxxxxxxxxx"
"[english]#UserReviews_RatingStats_plural"	"%1$s of %2$s people (%3$s%%) found this review helpful"
"#UserReviews_WasHelpful"	"xxxxxxxxxxxxxxxxxxxx"
"[english]#UserReviews_WasHelpful"	"Was this review helpful?"
"#UserReviews_RateUp"	"xxxxxxxxxxxxxxxxxxxx"
"[english]#UserReviews_RateUp"	"Yes"
"#UserReviews_RateDown"	"xxxxxxxxxxxxxxxxxxxx"
"[english]#UserReviews_RateDown"	"No"
"#UserReviews_ReportTooltip"	"xxxxxxxxxxxxxxxxxxxx"
"[english]#UserReviews_ReportTooltip"	"Report this review for violating the Steam Terms of Service or Online Conduct Rules."
"#UserReviews_Visibility"	"xxxxxxxxxxxxxxxxxxxx"
"[english]#UserReviews_Visibility"	"Visibility"
"#UserReviews_Visibility_Public"	"xxxxxxxxxxxxxxxxxxxx"
"[english]#UserReviews_Visibility_Public"	"Public"
"#UserReviews_Visibility_FriendsOnly"	"xxxxxxxxxxxxxxxxxxxx"
"[english]#UserReviews_Visibility_FriendsOnly"	"Friends Only"
"#UserReviews_WouldRecommend_Software"	"xxxxxxxxxxxxxxxxxxxx"
"[english]#UserReviews_WouldRecommend_Software"	"Do you recommend this software?"
"#UserReviews_WouldRecommend_Game"	"xxxxxxxxxxxxxxxxxxxx"
"[english]#UserReviews_WouldRecommend_Game"	"Do you recommend this game?"
"#UserReviews_WouldRecommend_Yes"	"xxxxxxxxxxxxxxxxxxxx"
"[english]#UserReviews_WouldRecommend_Yes"	"Yes"
"#UserReviews_WouldRecommend_No"	"xxxxxxxxxxxxxxxxxxxx"
"[english]#UserReviews_WouldRecommend_No"	"No"
"#UserReviews_Language"	"xxxxxxxxxxxxxxxxxxxx"
"[english]#UserReviews_Language"	"Language"
"#UserReviews_GameStats_LastTwoWeeks"	"xxxxxxxxxxxxxxxxxxxx"
"[english]#UserReviews_GameStats_LastTwoWeeks"	"%s last two weeks"
"#UserReviews_GameStats_HoursOnRecord"	"xxxxxxxxxxxxxxxxxxxx"
"[english]#UserReviews_GameStats_HoursOnRecord"	"%s hrs on record"
"#UserReviews_Recommended"	"xxxxxxxxxxxxxxxxxxxx"
"[english]#UserReviews_Recommended"	"Recommended"
"#UserReviews_NotRecommended"	"xxxxxxxxxxxxxxxxxxxx"
"[english]#UserReviews_NotRecommended"	"Not Recommended"
"#UserReviews_StoreLink"	"xxxxxxxxxxxxxxxxxxxx"
"[english]#UserReviews_StoreLink"	"View Store Page"
"#UserReviews_CommunityLink"	"xxxxxxxxxxxxxxxxxxxx"
"[english]#UserReviews_CommunityLink"	"View Community Hub"
"#UserReviews_FindMoreLink"	"xxxxxxxxxxxxxxxxxxxx"
"[english]#UserReviews_FindMoreLink"	"Find More Like This"
"#UserReviews_UpdateDialog_Title"	"xxxxxxxxxxxxxxxxxxxx"
"[english]#UserReviews_UpdateDialog_Title"	"Update Your Review"
"#UserReviews_OwnerControls"	"xxxxxxxxxxxxxxxxxxxx"
"[english]#UserReviews_OwnerControls"	"Owner Controls"
"#UserReviews_ModeratorControls"	"xxxxxxxxxxxxxxxxxxxx"
"[english]#UserReviews_ModeratorControls"	"Moderator Controls"
"#UserReviews_EditReview"	"xxxxxxxxxxxxxxxxxxxx"
"[english]#UserReviews_EditReview"	"Edit Review"
"#UserReviews_EditReview_ErrorDialog_Title"	"xxxxxxxxxxxxxxxxxxxx"
"[english]#UserReviews_EditReview_ErrorDialog_Title"	"Error"
"#UserReviews_EditReview_ErrorDialog_Text"	"xxxxxxxxxxxxxxxxxxxx"
"[english]#UserReviews_EditReview_ErrorDialog_Text"	"Your review cannot be empty."
"#UserReviews_SaveChanges"	"xxxxxxxxxxxxxxxxxxxx"
"[english]#UserReviews_SaveChanges"	"Save Changes"
"#UserReviews_Cancel"	"xxxxxxxxxxxxxxxxxxxx"
"[english]#UserReviews_Cancel"	"Cancel"
"#UserReviews_DeleteReview"	"xxxxxxxxxxxxxxxxxxxx"
"[english]#UserReviews_DeleteReview"	"Delete"
"#UserReviews_DeleteReview_Dialog_Title"	"xxxxxxxxxxxxxxxxxxxx"
"[english]#UserReviews_DeleteReview_Dialog_Title"	"Delete Review?"
"#UserReviews_DeleteReview_Dialog_Text"	"xxxxxxxxxxxxxxxxxxxx"
"[english]#UserReviews_DeleteReview_Dialog_Text"	"Are you sure you want to delete this review? This cannot be undone."
"#UserReviews_ChangeVisibility"	"xxxxxxxxxxxxxxxxxxxx"
"[english]#UserReviews_ChangeVisibility"	"Change Visibility"
"#UserReviews_Visiblity_Public"	"xxxxxxxxxxxxxxxxxxxx"
"[english]#UserReviews_Visiblity_Public"	"Public"
"#UserReviews_Visiblity_FriendsOnly"	"xxxxxxxxxxxxxxxxxxxx"
"[english]#UserReviews_Visiblity_FriendsOnly"	"Friends Only"
"#UserReviews_SetLanguage"	"xxxxxxxxxxxxxxxxxxxx"
"[english]#UserReviews_SetLanguage"	"Set Review Language"
"#UserReviews_ClearReports"	"xxxxxxxxxxxxxxxxxxxx"
"[english]#UserReviews_ClearReports"	"Clear Reports"
"#UserReviews_ClearReportsDialog_Title"	"xxxxxxxxxxxxxxxxxxxx"
"[english]#UserReviews_ClearReportsDialog_Title"	"Clear Reports"
"#UserReviews_ClearReportsDialog_Text"	"xxxxxxxxxxxxxxxxxxxx"
"[english]#UserReviews_ClearReportsDialog_Text"	"Are you sure you want to clear all reports? This cannot be undone!"
"#UserReviews_ForceHidden"	"xxxxxxxxxxxxxxxxxxxx"
"[english]#UserReviews_ForceHidden"	"Ban Status"
"#UserReviews_ForceHidden_Yes"	"xxxxxxxxxxxxxxxxxxxx"
"[english]#UserReviews_ForceHidden_Yes"	"Banned"
"#UserReviews_ForceHidden_No"	"xxxxxxxxxxxxxxxxxxxx"
"[english]#UserReviews_ForceHidden_No"	"Not Banned"
"#UserReviews_DeveloperFlagged"	"xxxxxxxxxxxxxxxxxxxx"
"[english]#UserReviews_DeveloperFlagged"	"Flag This Review As:"
"#UserReviews_DeveloperFlagged_None"	"&lt;ei määritelty&gt;"
"[english]#UserReviews_DeveloperFlagged_None"	"&lt;none specified&gt;"
"#UserReviews_DeveloperFlagged_Abusive"	"xxxxxxxxxxxxxxxxxxxx"
"[english]#UserReviews_DeveloperFlagged_Abusive"	"Abusive"
"#UserReviews_DeveloperFlagged_OffTopic"	"xxxxxxxxxxxxxxxxxxxx"
"[english]#UserReviews_DeveloperFlagged_OffTopic"	"Off-topic"
"#UserReviews_Banned"	"xxxxxxxxxxxxxxxxxxxx"
"[english]#UserReviews_Banned"	"This review has been banned for violating the Steam Terms of Service. It cannot be modified by the reviewer."
"#UserReviews_BannedBy"	"xxxxxxxxxxxxxxxxxxxx"
"[english]#UserReviews_BannedBy"	"Banned By: "
"#UserReviews_FlaggedByDeveloper"	"xxxxxxxxxxxxxxxxxxxx"
"[english]#UserReviews_FlaggedByDeveloper"	"This review has been flagged by a developer of %1$s as '%2$s' and will show up in a collapsed form on the store. It cannot be modified by the reviewer until the flag has been cleared."
"#UserReviews_FlaggedByDeveloper_AppHub"	"xxxxxxxxxxxxxxxxxxxx"%s\". Voit silti lukea sen, jos haluat."
"[english]#UserReviews_FlaggedByDeveloper_AppHub"	"This review was marked as '%s' by the developer. You can still see the review if you wish."
"#UserReviews_FlaggedBy"	"xxxxxxxxxxxxxxxxxxxx"
"[english]#UserReviews_FlaggedBy"	"Flagged By: "
"#UserReviews_Posted"	"xxxxxxxxxxxxxxxxxxxx"
"[english]#UserReviews_Posted"	"Posted: %1$s"
"#UserReviews_Updated"	"xxxxxxxxxxxxxxxxxxxx"
"[english]#UserReviews_Updated"	"Updated: %1$s"
"#UserReviews_NumGamesOwned"	"xxxxxxxxxxxxxxxxxxxx"
"[english]#UserReviews_NumGamesOwned"	"1 product in account"
"#UserReviews_NumGamesOwned_plural"	"xxxxxxxxxxxxxxxxxxxx"
"[english]#UserReviews_NumGamesOwned_plural"	"%1s products in account"
"#UserReviews_Error_NotLoggedIn_Text"	"xxxxxxxxxxxxxxxxxxxx"
"[english]#UserReviews_Error_NotLoggedIn_Text"	"You must be logged in to perform that action."
"#UserReviews_Error_AccessDenied_Text"	"xxxxxxxxxxxxxxxxxxxx"
"[english]#UserReviews_Error_AccessDenied_Text"	"Your account does not have sufficient privileges to perform this action."
"#UserReviews_AboutReviewsTitle"	"xxxxxxxxxxxxxxxxxxxx"
"[english]#UserReviews_AboutReviewsTitle"	"About Reviews"
"#UserReviews_ViewReportsDialog_Title"	"xxxxxxxxxxxxxxxxxxxx"
"[english]#UserReviews_ViewReportsDialog_Title"	"All Reports"
"#UserReviews_SetDeveloperResponse"	"xxxxxxxxxxxxxxxxxxxx"
"[english]#UserReviews_SetDeveloperResponse"	"Write a response"
"#UserReviews_SetDeveloperResponseDialog_Title"	"xxxxxxxxxxxxxxxxxxxx"
"[english]#UserReviews_SetDeveloperResponseDialog_Title"	"Write a response"
"#UserReviews_OfficialDeveloperResponse"	"xxxxxxxxxxxxxxxxxxxx"
"[english]#UserReviews_OfficialDeveloperResponse"	"Developer response:"
"#UserReviews_OfficialDeveloperResponseExists"	"xxxxxxxxxxxxxxxxxxxx"
"[english]#UserReviews_OfficialDeveloperResponseExists"	"A developer has responded to this review"
"#UserReviews_OfficialDeveloperResponse_View"	"xxxxxxxxxxxxxxxxxxxx"
"[english]#UserReviews_OfficialDeveloperResponse_View"	"(view response)"
"#UserReviews_BanHelper"	"xxxxxxxxxxxxxxxxxxxx"
"[english]#UserReviews_BanHelper"	"You should only ban an item if it is truely off-topic or abusive. If it is simply negative or in bad taste, we should leave it and let votes take care of it."
"#UserReviews_DeveloperResponseBadge"	"xxxxxxxxxxxxxxxxxxxx"
"[english]#UserReviews_DeveloperResponseBadge"	"developer"
"#Community_RemoveLink_BeWary"	"{LINKKI POISTETTU - Ole ystävällinen ja älä spammi, ja ole varovainen huijausten varalta.}"
"[english]#Community_RemoveLink_BeWary"	"{LINK REMOVED - Please don't spam, and be wary of scams.}"
"#DynamicLinkType_WorkshopItem"	"xxxxxxxxxxxxxxxxxxxx"
"[english]#DynamicLinkType_WorkshopItem"	"A Workshop Item for %1$s"
"#DynamicLinkType_Screenshot"	"xxxxxxxxxxxxxxxxxxxx"
"[english]#DynamicLinkType_Screenshot"	"A Screenshot of %1$s"
"#DynamicLinkType_Video"	"xxxxxxxxxxxxxxxxxxxx"
"[english]#DynamicLinkType_Video"	"A Video of %1$s"
"#DynamicLinkType_Art"	"xxxxxxxxxxxxxxxxxxxx"
"[english]#DynamicLinkType_Art"	"Community Created Artwork for %1$s"
"#DynamicLinkType_YouTubeVideo"	"xxxxxxxxxxxxxxxxxxxx"
"[english]#DynamicLinkType_YouTubeVideo"	"YouTube™ Video"
"#DynamicLinkType_GreenlightGame"	"xxxxxxxxxxxxxxxxxxxx"
"[english]#DynamicLinkType_GreenlightGame"	"Greenlight Game"
"#DynamicLinkType_GreenlightConcept"	"xxxxxxxxxxxxxxxxxxxx"
"[english]#DynamicLinkType_GreenlightConcept"	"Greenlight Concept"
"#DynamicLinkType_GreenlightSoftware"	"xxxxxxxxxxxxxxxxxxxx"
"[english]#DynamicLinkType_GreenlightSoftware"	"Greenlight Software"
"#DynamicLinkType_WebGuide"	"xxxxxxxxxxxxxxxxxxxx"
"[english]#DynamicLinkType_WebGuide"	"A Guide for %1$s"
"#DynamicLinkType_YouTubeVideo_Error_Network"	"xxxxxxxxxxxxxxxxxxxx"
"[english]#DynamicLinkType_YouTubeVideo_Error_Network"	"Could not contact YouTube™"
"#DynamicLinkType_YouTubeVideo_Error_PrivateFile"	"xxxxxxxxxxxxxxxxxxxx"
"[english]#DynamicLinkType_YouTubeVideo_Error_PrivateFile"	"The YouTube™ video has been marked private."
"#DynamicLinkType_YouTubeVideo_Error_NotFound"	"xxxxxxxxxxxxxxxxxxxx"
"[english]#DynamicLinkType_YouTubeVideo_Error_NotFound"	"The YouTube™ video could not be found."
"#DynamicLinkType_YouTubeVideo_Views"	"xxxxxxxxxxxxxxxxxxxx"
"[english]#DynamicLinkType_YouTubeVideo_Views"	"Views: %1$s"
"#DynamicLinkType_NewsPost"	"xxxxxxxxxxxxxxxxxxxx"
"[english]#DynamicLinkType_NewsPost"	"News"
"#DynamicLinkType_ClanAnnouncement"	"xxxxxxxxxxxxxxxxxxxx"
"[english]#DynamicLinkType_ClanAnnouncement"	"Announcement"
"#DynamicLink_Author"	"xxxxxxxxxxxxxxxxxxxx"
"[english]#DynamicLink_Author"	"By: %s"
"#Economy_SteamContext_ItemRewards"	"xxxxxxxxxxxxxxxxxxxx"
"[english]#Economy_SteamContext_ItemRewards"	"Item Rewards"
"#economy_itemreward_rarity1"	"xxxxxxxxxxxxxxxxxxxx"
"[english]#economy_itemreward_rarity1"	"Common"
"#economy_itemreward_rarity2"	"xxxxxxxxxxxxxxxxxxxx"
"[english]#economy_itemreward_rarity2"	"Uncommon"
"#economy_itemreward_rarity3"	"xxxxxxxxxxxxxxxxxxxx"
"[english]#economy_itemreward_rarity3"	"Rare"
"#economy_itemreward_rarity5"	"xxxxxxxxxxxxxxxxxxxx"
"[english]#economy_itemreward_rarity5"	"Precious"
"#economy_itemreward_rarity6"	"xxxxxxxxxxxxxxxxxxxx"
"[english]#economy_itemreward_rarity6"	"Unparalleled"
"#Promo_Winter2013_FAQ_Hover_Exclusive"	"xxxxxxxxxxxxxxxxxxxx"
"[english]#Promo_Winter2013_FAQ_Hover_Exclusive"	"Steam Holiday Sale 2013 Exclusive"
"#Promo_Winter2013_Rewards_XItemsCrafted"	"xxxxxxxxxxxxxxxxxxxx"
"[english]#Promo_Winter2013_Rewards_XItemsCrafted"	"%s Crafted"
"language_selection_ukrainian"	"xxxxxxxxxxxxxxxxxxxx"
"[english]language_selection_ukrainian"	"Українська (Ukrainian)"
"#lang_ukrainian"	"xxxxxxxxxxxxxxxxxxxx"
"[english]#lang_ukrainian"	"Ukrainian"
}
}
