"lang"
{
"Language"	"Estonian"
"Tokens"
{
"TextEntry_Cut"	"Lõika"
"[english]TextEntry_Cut"	"Cut"
"TextEntry_Copy"	"Kopeeri"
"[english]TextEntry_Copy"	"Copy"
"TextEntry_Paste"	"Kleebi"
"[english]TextEntry_Paste"	"Paste"
"TextEntry_SelectAll"	"Vali kõik"
"[english]TextEntry_SelectAll"	"Select all"
"FileOpenDialog_Open"	"Ava"
"[english]FileOpenDialog_Open"	"Open"
"FileOpenDialog_Cancel"	"Loobu"
"[english]FileOpenDialog_Cancel"	"Cancel"
"FileOpenDialog_Look_in"	"Vaata:"
"[english]FileOpenDialog_Look_in"	"Look in:"
"FileOpenDialog_File_Name"	"Faili nimi:"
"[english]FileOpenDialog_File_Name"	"File name:"
"FileOpenDialog_File_Type"	"Faili tüüp:"
"[english]FileOpenDialog_File_Type"	"File type:"
"FileOpenDialog_Icon"	" "
"[english]FileOpenDialog_Icon"	" "
"FileOpenDialog_Name"	"Nimi"
"[english]FileOpenDialog_Name"	"Name"
"FileOpenDialog_Type"	"Tüüp"
"[english]FileOpenDialog_Type"	"Type"
"SysMenu_Minimize"	"Minimeeri"
"[english]SysMenu_Minimize"	" Minimize "
"SysMenu_Maximize"	"Maksimeeri"
"[english]SysMenu_Maximize"	" Maximize "
"SysMenu_Close"	"Sulge"
"[english]SysMenu_Close"	" Close "
"Frame_Untitled"	"Nimetu"
"[english]Frame_Untitled"	"Untitled"
"MessageBox_OK"	"OK"
"[english]MessageBox_OK"	"OK"
"PropertyDialog_OK"	"OK"
"[english]PropertyDialog_OK"	"OK"
"PropertyDialog_Cancel"	"Loobu"
"[english]PropertyDialog_Cancel"	"Cancel"
"PropertyDialog_Apply"	"Rakenda"
"[english]PropertyDialog_Apply"	"Apply"
"QueryBox_Cancel"	"Loobu"
"[english]QueryBox_Cancel"	"Cancel"
"WizardPanel_Next"	"Edasi >"
"[english]WizardPanel_Next"	"Next >"
"WizardPanel_Back"	"< Tagasi"
"[english]WizardPanel_Back"	"< Back"
"WizardPanel_Finish"	"Valmis"
"[english]WizardPanel_Finish"	"Finish"
"WizardPanel_Cancel"	"Loobu"
"[english]WizardPanel_Cancel"	"Cancel"
"vgui_ok"	"OK"
"[english]vgui_ok"	"OK"
"vgui_close"	"Sulge"
"[english]vgui_close"	"Close"
"vgui_Cancel"	"Loobu"
"[english]vgui_Cancel"	"Cancel"
"vgui_select"	"Vali"
"[english]vgui_select"	"Select"
"vgui_createfolder"	"Uus kaust..."
"[english]vgui_createfolder"	"New Folder..."
"vgui_next"	"Edasi >"
"[english]vgui_next"	"Next >"
"vgui_back"	"< Tagasi"
"[english]vgui_back"	"< Back"
"vgui_CreateDirectoryFail_Title"	"Kausta loomine - Viga"
"[english]vgui_CreateDirectoryFail_Title"	"Create Folder - Error"
"vgui_CreateDirectoryFail_Info"	"Ei saanud kausta luua, see ketas on kirjutuskaitstud."
"[english]vgui_CreateDirectoryFail_Info"	"Failed to create a folder, this drive is read-only."
"vgui_CreateDirectoryFail_AlreadyExists"	"See kaust on juba olemas."
"[english]vgui_CreateDirectoryFail_AlreadyExists"	"That folder already exists."
"TextEntry_Language"	"Keel"
"[english]TextEntry_Language"	"Language"
"TextEntry_ConversionMode"	"Konvertimisrežiim"
"[english]TextEntry_ConversionMode"	"Conversion Mode"
"TextEntry_SentenceMode"	"Lauserežiim"
"[english]TextEntry_SentenceMode"	"Sentence Mode"
"IME_English"	"inglise"
"[english]IME_English"	"English"
"IME_Chinese"	"hiina"
"[english]IME_Chinese"	"Chinese"
"IME_Korean"	"korea"
"[english]IME_Korean"	"Korean"
"IME_Hiragana"	"hiragana"
"[english]IME_Hiragana"	"Hiragana"
"IME_FullWidthKatakana"	"Full-width katakana"
"[english]IME_FullWidthKatakana"	"Full-width Katakana"
"IME_FullWidthAlphanumeric"	"Full-width Alphanumeric"
"[english]IME_FullWidthAlphanumeric"	"Full-width Alphanumeric"
"IME_HalfWidthKatakana"	"Half-width katakana"
"[english]IME_HalfWidthKatakana"	"Half-width Katakana"
"IME_HalfWidthAlphanumeric"	"Half-width Alphanumeric"
"[english]IME_HalfWidthAlphanumeric"	"Half-width Alphanumeric"
"IME_General"	"Üldine"
"[english]IME_General"	"General"
"IME_BiasNames"	"Eelistus nimedele"
"[english]IME_BiasNames"	"Bias for Names"
"IME_BiasSpeech"	"Eelistus häälele"
"[english]IME_BiasSpeech"	"Bias for Speech"
"IME_NoConversion"	"Konvertimiseta"
"[english]IME_NoConversion"	"No Conversion"
"IME_0404"	"hiina (Taiwan)"
"[english]IME_0404"	"Chinese (Taiwan)"
"IME_0804"	"hiina (Hiina RV)"
"[english]IME_0804"	"Chinese (PRC)"
"IME_0409"	"inglise (Ühendriigid)"
"[english]IME_0409"	"English (United States)"
"IME_0411"	"jaapani"
"[english]IME_0411"	"Japanese"
"IME_0412"	"korea"
"[english]IME_0412"	"Korean"
"IME_0419"	"vene"
"[english]IME_0419"	"Russian"
"IME_041e"	"tai"
"[english]IME_041e"	"Thai"
"IME_040c"	"prantsuse (standardne)"
"[english]IME_040c"	"French (Standard)"
"IME_0407"	"saksa (standardne)"
"[english]IME_0407"	"German (Standard)"
"IME_0410"	"itaalia (standardne)"
"[english]IME_0410"	"Italian (Standard)"
"IME_040a"	"hispaania (Hispaania, traditsiooniline)"
"[english]IME_040a"	"Spanish (Spain, Traditional Sort)"
"vgui_FileCopyDialog_Title"	"Kopeerimine..."
"[english]vgui_FileCopyDialog_Title"	"Copying..."
"vgui_FileMoveDialog_Title"	"Liigutamine..."
"[english]vgui_FileMoveDialog_Title"	"Moving..."
"vgui_FileCopy_Estimate"	"%s1 veel ees"
"[english]vgui_FileCopy_Estimate"	"%s1 remaining"
"vgui_FileCopy_Copying_Multiple"	"Kopeerimisel '%s1' (%s2 veel ees)"
"[english]vgui_FileCopy_Copying_Multiple"	"Copying '%s1' (%s2 remaining)"
"vgui_FileCopy_Copying_Single"	"Kopeerimisel '%s1'"
"[english]vgui_FileCopy_Copying_Single"	"Copying '%s1'"
"vgui_FileCopy_Ovewwrite_Title"	"Faili(de) ülekirjutamine"
"[english]vgui_FileCopy_Ovewwrite_Title"	"Overwrite file(s)"
"vgui_FileCopy_Ovewwrite_Prompt"	"Kirjutada üle '%filename%'?"
"[english]vgui_FileCopy_Ovewwrite_Prompt"	"Overwrite '%filename%'?"
"SMPEvent_AppLaunch"	"Rakenduse käivitus"
"[english]SMPEvent_AppLaunch"	"App Launch"
"SMPEvent_AppExit"	"Rakenduse sulgemine"
"[english]SMPEvent_AppExit"	"App Exit"
"SMPEvent_Close"	"Sulge"
"[english]SMPEvent_Close"	"Close"
"SMPEvent_FadeOut"	"Haihtu"
"[english]SMPEvent_FadeOut"	"Fade Out"
"SMPEvent_MediaBegin"	"Meedia algab"
"[english]SMPEvent_MediaBegin"	"Media Begin"
"SMPEvent_MediaEnd"	"Meedia lõpeb"
"[english]SMPEvent_MediaEnd"	"Media End"
"SMPEvent_Play"	"Mängi"
"[english]SMPEvent_Play"	"Play"
"SMPEvent_JumpHome"	"Hüppa koju"
"[english]SMPEvent_JumpHome"	"Jump Home"
"SMPEvent_JumpEnd"	"Hüppa lõppu"
"[english]SMPEvent_JumpEnd"	"Jump To End"
"SMPEvent_Pause"	"Paus"
"[english]SMPEvent_Pause"	"Pause"
"SMPEvent_Stop"	"Stopp"
"[english]SMPEvent_Stop"	"Stop"
"SMPEvent_JumpFrom"	"Puhasta sealt alates"
"[english]SMPEvent_JumpFrom"	"Scrub From"
"SMPEvent_JumpTo"	"Puhasta kuni"
"[english]SMPEvent_JumpTo"	"Scrub To"
"SMPEvent_StepFwd"	"Samm edasi"
"[english]SMPEvent_StepFwd"	"Step Forward"
"SMPEvent_StepBack"	"Samm tagasi"
"[english]SMPEvent_StepBack"	"Step Backwards"
"SMPEvent_JumpFwd"	"Hüppa edasi"
"[english]SMPEvent_JumpFwd"	"Jump Forward"
"SMPEvent_JumpBack"	"Hüppa tagasi"
"[english]SMPEvent_JumpBack"	"Jump Backwards"
"SMPEvent_Repeat"	"Korda"
"[english]SMPEvent_Repeat"	"Repeat"
"SMPEvent_Maximize"	"Maksimeeri"
"[english]SMPEvent_Maximize"	"Maximize"
"SMPEvent_Minimize"	"Minimeeri"
"[english]SMPEvent_Minimize"	"Minimize"
"SMPEvent_Restore"	"Taasta"
"[english]SMPEvent_Restore"	"Restore"
"SMPStats_UserId"	"Kasutaja ID:"
"[english]SMPStats_UserId"	"User Id:"
"SMPStats_Filename"	"Faili nimi:"
"[english]SMPStats_Filename"	"Filename:"
"SMPStats_EventTitle"	"Sündmus"
"[english]SMPStats_EventTitle"	"Event"
"SMPStats_TimeTitle"	"Aeg (ms)"
"[english]SMPStats_TimeTitle"	"Time (ms)"
"SMPStats_PositionTitle"	"Positsioon (ms)"
"[english]SMPStats_PositionTitle"	"Position (ms)"
"SMPStats_DialogTitle"	"Andmete kogumise eelistused"
"[english]SMPStats_DialogTitle"	"Data Collection Preferences"
"SMPStats_DontAskAgain"	"Ära küsi enam"
"[english]SMPStats_DontAskAgain"	"Don't ask again"
"vgui_Accept"	"Nõustu"
"[english]vgui_Accept"	"Accept"
"vgui_Decline"	"Keeldu"
"[english]vgui_Decline"	"Decline"
"vgui_TimeLeftYearOrMore"	"üle 1 aasta"
"[english]vgui_TimeLeftYearOrMore"	"more than 1 year"
"vgui_TimeLeftDay"	"%days% päev"
"[english]vgui_TimeLeftDay"	"%days% day"
"vgui_TimeLeftDays"	"%days% päeva"
"[english]vgui_TimeLeftDays"	"%days% days"
"vgui_TimeLeftDayRemaining"	"%days% päev jäänud"
"[english]vgui_TimeLeftDayRemaining"	"%days% day remaining"
"vgui_TimeLeftDaysRemaining"	"%days% päeva jäänud"
"[english]vgui_TimeLeftDaysRemaining"	"%days% days remaining"
"vgui_TimeLeftHour"	"%hours% tund"
"[english]vgui_TimeLeftHour"	"%hours% hour"
"vgui_TimeLeftHours"	"%hours% tundi"
"[english]vgui_TimeLeftHours"	"%hours% hours"
"vgui_TimeLeftHourRemaining"	"%hours% tund jäänud"
"[english]vgui_TimeLeftHourRemaining"	"%hours% hour remaining"
"vgui_TimeLeftHoursRemaining"	"%hours% tundi jäänud"
"[english]vgui_TimeLeftHoursRemaining"	"%hours% hours remaining"
"vgui_TimeLeftMinute"	"%minutes% minut"
"[english]vgui_TimeLeftMinute"	"%minutes% minute"
"vgui_TimeLeftMinutes"	"%minutes% minutit"
"[english]vgui_TimeLeftMinutes"	"%minutes% minutes"
"vgui_TimeLeftMinuteRemaining"	"%minutes% minut jäänud"
"[english]vgui_TimeLeftMinuteRemaining"	"%minutes% minute remaining"
"vgui_TimeLeftMinutesRemaining"	"%minutes% minutit jäänud"
"[english]vgui_TimeLeftMinutesRemaining"	"%minutes% minutes remaining"
"vgui_TimeLeftSecond"	"%seconds% sekund"
"[english]vgui_TimeLeftSecond"	"%seconds% second"
"vgui_TimeLeftSeconds"	"%seconds% sekundit"
"[english]vgui_TimeLeftSeconds"	"%seconds% seconds"
"vgui_TimeLeftSecondRemaining"	"%seconds% sekund jäänud"
"[english]vgui_TimeLeftSecondRemaining"	"%seconds% second remaining"
"vgui_TimeLeftSecondsRemaining"	"%seconds% sekundit jäänud"
"[english]vgui_TimeLeftSecondsRemaining"	"%seconds% seconds remaining"
"vgui_TimeLeftDaysHours"	"%days% päeva %hours% tundi"
"[english]vgui_TimeLeftDaysHours"	"%days% days %hours% hours"
"vgui_TimeLeftDaysHour"	"%days% päeva %hours% tund"
"[english]vgui_TimeLeftDaysHour"	"%days% days %hours% hour"
"vgui_TimeLeftDayHours"	"%days% päev %hours% tundi"
"[english]vgui_TimeLeftDayHours"	"%days% day %hours% hours"
"vgui_TimeLeftDayHour"	"%days% päev %hours% tund"
"[english]vgui_TimeLeftDayHour"	"%days% day %hours% hour"
"vgui_TimeLeftDaysHoursRemaining"	"%days% päeva %hours% tundi jäänud"
"[english]vgui_TimeLeftDaysHoursRemaining"	"%days% days %hours% hours remaining"
"vgui_TimeLeftDaysHourRemaining"	"%days% päeva %hours% tund jäänud"
"[english]vgui_TimeLeftDaysHourRemaining"	"%days% days %hours% hour remaining"
"vgui_TimeLeftDayHoursRemaining"	"%days% päev %hours% tundi jäänud"
"[english]vgui_TimeLeftDayHoursRemaining"	"%days% day %hours% hours remaining"
"vgui_TimeLeftDayHourRemaining"	"%days% päev %hours% tund jäänud"
"[english]vgui_TimeLeftDayHourRemaining"	"%days% day %hours% hour remaining"
"vgui_TimeLeftHoursMinutes"	"%hours% tundi %minutes% minutit"
"[english]vgui_TimeLeftHoursMinutes"	"%hours% hours %minutes% minutes"
"vgui_TimeLeftHoursMinute"	"%hours% tundi %minutes% minut"
"[english]vgui_TimeLeftHoursMinute"	"%hours% hours %minutes% minute"
"vgui_TimeLeftHourMinutes"	"%hours% tund %minutes% minutit"
"[english]vgui_TimeLeftHourMinutes"	"%hours% hour %minutes% minutes"
"vgui_TimeLeftHourMinute"	"%hours% tund %minutes% minut"
"[english]vgui_TimeLeftHourMinute"	"%hours% hour %minutes% minute"
"vgui_TimeLeftHoursMinutesRemaining"	"%hours% tundi %minutes% minutit jäänud"
"[english]vgui_TimeLeftHoursMinutesRemaining"	"%hours% hours %minutes% minutes remaining"
"vgui_TimeLeftHoursMinuteRemaining"	"%hours% tundi %minutes% minut jäänud"
"[english]vgui_TimeLeftHoursMinuteRemaining"	"%hours% hours %minutes% minute remaining"
"vgui_TimeLeftHourMinutesRemaining"	"%hours% tund %minutes% minutit jäänud"
"[english]vgui_TimeLeftHourMinutesRemaining"	"%hours% hour %minutes% minutes remaining"
"vgui_TimeLeftHourMinuteRemaining"	"%hours% tund %minutes% minut jäänud"
"[english]vgui_TimeLeftHourMinuteRemaining"	"%hours% hour %minutes% minute remaining"
"vgui_TimeLeftMinutesSeconds"	"%minutes% minutit %seconds% sekundit"
"[english]vgui_TimeLeftMinutesSeconds"	"%minutes% minutes %seconds% seconds"
"vgui_TimeLeftMinutesSecond"	"%minutes% minutit %seconds% sekund"
"[english]vgui_TimeLeftMinutesSecond"	"%minutes% minutes %seconds% second"
"vgui_TimeLeftMinuteSeconds"	"%minutes% minut %seconds% sekundit"
"[english]vgui_TimeLeftMinuteSeconds"	"%minutes% minute %seconds% seconds"
"vgui_TimeLeftMinuteSecond"	"%minutes% minut %seconds% sekund"
"[english]vgui_TimeLeftMinuteSecond"	"%minutes% minute %seconds% second"
"vgui_TimeLeftMinutesSecondsRemaining"	"%minutes% minutit %seconds% sekundit jäänud"
"[english]vgui_TimeLeftMinutesSecondsRemaining"	"%minutes% minutes %seconds% seconds remaining"
"vgui_TimeLeftMinutesSecondRemaining"	"%minutes% minutit %seconds% sekund jäänud"
"[english]vgui_TimeLeftMinutesSecondRemaining"	"%minutes% minutes %seconds% second remaining"
"vgui_TimeLeftMinuteSecondsRemaining"	"%minutes%" minut %seconds% sekundit jäänud"
"[english]vgui_TimeLeftMinuteSecondsRemaining"	"%minutes% minute %seconds% seconds remaining"
"vgui_TimeLeftMinuteSecondRemaining"	"%minutes% minut %seconds% sekund jäänud"
"[english]vgui_TimeLeftMinuteSecondRemaining"	"%minutes% minute %seconds% second remaining"
"vgui_Today"	"Täna"
"[english]vgui_Today"	"Today"
"vgui_Yesterday"	"Eile"
"[english]vgui_Yesterday"	"Yesterday"
"vgui_Tomorrow"	"Homme"
"[english]vgui_Tomorrow"	"Tomorrow"
"vgui_OnForDays"	"%days%-ks päevaks"
"[english]vgui_OnForDays"	"On for %days% days"
"vgui_OnForHours"	"%hours%-ks tunniks"
"[english]vgui_OnForHours"	"On for %hours% hours"
"vgui_OnForMinutes"	"%minutes%-ks minutiks"
"[english]vgui_OnForMinutes"	"On for %minutes% minutes"
"vgui_OnForSeconds"	"%seconds%-ks sekundiks"
"[english]vgui_OnForSeconds"	"On for %seconds% seconds"
"vgui_OnForDay"	"%days%-ks päevaks"
"[english]vgui_OnForDay"	"On for %days% day"
"vgui_OnForHour"	"%hours%-ks tunniks"
"[english]vgui_OnForHour"	"On for %hours% hour"
"vgui_OnForMinute"	"%minutes%-ks minutiks"
"[english]vgui_OnForMinute"	"On for %minutes% minute"
"vgui_OnForSecond"	"%seconds%-ks sekundiks"
"[english]vgui_OnForSecond"	"On for %seconds% second"
"vgui_LastOnYearOrMore"	"Viimati sees: üle aasta tagasi"
"[english]vgui_LastOnYearOrMore"	"Last Online: more than 1 year ago"
"vgui_LastOnDays"	"Viimati sees: %days% päeva tagasi"
"[english]vgui_LastOnDays"	"Last Online: %days% days ago"
"vgui_LastOnHours"	"Viimati sees: %hours% tundi tagasi"
"[english]vgui_LastOnHours"	"Last Online: %hours% hours ago"
"vgui_LastOnMinutes"	"Viimati sees: %minutes% minutit tagasi"
"[english]vgui_LastOnMinutes"	"Last Online: %minutes% minutes ago"
"vgui_LastOnSeconds"	"Viimati sees: %seconds% sekundit tagasi"
"[english]vgui_LastOnSeconds"	"Last Online: %seconds% seconds ago"
"vgui_LastOnDay"	"Viimati sees: %days% päev tagasi"
"[english]vgui_LastOnDay"	"Last Online: %days% day ago"
"vgui_LastOnHour"	"Viimati sees: %hours% tund tagasi"
"[english]vgui_LastOnHour"	"Last Online: %hours% hour ago"
"vgui_LastOnMinute"	"Viimati sees: %minutes% minut tagasi"
"[english]vgui_LastOnMinute"	"Last Online: %minutes% minute ago"
"vgui_LastOnSecond"	"Viimati sees: %seconds% sekund tagasi"
"[english]vgui_LastOnSecond"	"Last Online: %seconds% second ago"
"vgui_TimeAgoYearOrMore"	"üle aasta tagasi"
"[english]vgui_TimeAgoYearOrMore"	"more than 1 year ago"
"vgui_TimeAgoDays"	"%days% päeva tagasi"
"[english]vgui_TimeAgoDays"	"%days% days ago"
"vgui_TimeAgoHours"	"%hours% tundi tagasi"
"[english]vgui_TimeAgoHours"	"%hours% hours ago"
"vgui_TimeAgoMinutes"	"%minutes% minutit tagasi"
"[english]vgui_TimeAgoMinutes"	"%minutes% minutes ago"
"vgui_TimeAgoSeconds"	"%seconds% sekundit tagasi"
"[english]vgui_TimeAgoSeconds"	"%seconds% seconds ago"
"vgui_TimeAgoDay"	"%days% päev tagasi"
"[english]vgui_TimeAgoDay"	"%days% day ago"
"vgui_TimeAgoHour"	"%hours% tund tagasi"
"[english]vgui_TimeAgoHour"	"%hours% hour ago"
"vgui_TimeAgoMinute"	"%minutes% minut tagasi"
"[english]vgui_TimeAgoMinute"	"%minutes% minute ago"
"vgui_TimeAgoSecond"	"%seconds% sekund tagasi"
"[english]vgui_TimeAgoSecond"	"%seconds% second ago"
"FileOpenDialog_Col_Name"	"Nimi"
"[english]FileOpenDialog_Col_Name"	"Name"
"FileOpenDialog_Col_Size"	"Suurus"
"[english]FileOpenDialog_Col_Size"	"Size"
"FileOpenDialog_Col_Type"	"Tüüp"
"[english]FileOpenDialog_Col_Type"	"Type"
"FileOpenDialog_Col_DateModified"	"Muudetud"
"[english]FileOpenDialog_Col_DateModified"	"Date Modified"
"FileOpenDialog_Col_DateCreated"	"Loodud"
"[english]FileOpenDialog_Col_DateCreated"	"Date Created"
"FileOpenDialog_Col_Attributes"	"Atribuudid"
"[english]FileOpenDialog_Col_Attributes"	"Attributes"
"FileOpenDialog_FileType_Folder"	"Kaust"
"[english]FileOpenDialog_FileType_Folder"	"File Folder"
"FileOpenDialog_ToolTip_Up"	"Üles"
"[english]FileOpenDialog_ToolTip_Up"	"Up"
"FileOpenDialog_ToolTip_NewFolder"	"Uus kaust"
"[english]FileOpenDialog_ToolTip_NewFolder"	"New Folder"
"FileOpenDialog_NewFolder_InputTitle"	"Uus kaust"
"[english]FileOpenDialog_NewFolder_InputTitle"	"New Folder"
"FileOpenDialog_NewFolderPrompt"	"Nimi:"
"[english]FileOpenDialog_NewFolderPrompt"	"Name:"
"FileOpenDialog_NewFolder_DefaultName"	"Uus kaust"
"[english]FileOpenDialog_NewFolder_DefaultName"	"New Folder"
"vgui_Webkit_error_title"	"Viga"
"[english]vgui_Webkit_error_title"	"Error"
"vgui_Webkit_pagetypeunsupported"	"Ei suuda lehte laadida, mittetoetatud leheformaat"
"[english]vgui_Webkit_pagetypeunsupported"	"Unable to load page, unsupported page format"
"vgui_Webkit_cachemiss"	"Sinu taotlus on aegunud. Andmete uuesti saatmiseks vajuta lae uuesti."
"[english]vgui_Webkit_cachemiss"	"Your form request has expired. Click reload to re-submit the form data."
"vgui_Webkit_badurl"	"Ei saa avada URL-i, vale hostinimi või formaat"
"[english]vgui_Webkit_badurl"	"Unable to load URL, bad hostname or format"
"vgui_Webkit_connectionproblem"	"Ei saanud serveriga ühendust. Server on ühendusest väljas või ei ole sa internetiga ühendatud."
"[english]vgui_Webkit_connectionproblem"	"Unable to connect to server. Server may be offline or you may not be connected to the internet."
"vgui_Webkit_unknown"	"Ei saanud veebilehte laadida (tundmatu viga)."
"[english]vgui_Webkit_unknown"	"Failed to load web page (unknown error)."
"vgui_HTMLBack"	"Tagasi"
"[english]vgui_HTMLBack"	"Back"
"vgui_HTMLForward"	"Edasi"
"[english]vgui_HTMLForward"	"Forward"
"vgui_HTMLReload"	"Lae uuesti"
"[english]vgui_HTMLReload"	"Reload"
"vgui_HTMLStop"	"Peata"
"[english]vgui_HTMLStop"	"Stop"
"vgui_HTMLViewSource"	"Vaata lähtekoodi..."
"[english]vgui_HTMLViewSource"	"View Source..."
"vgui_Webkit_error_header"	"Veakood: "
"[english]vgui_Webkit_error_header"	"Error Code: "
"vgui_Webkit_proxyconnectionproblem"	"Ei saanud ühendust HTTP proksiga. Su proksi on valesti seadistatud või ühendusest väljas."
"[english]vgui_Webkit_proxyconnectionproblem"	"Unable to connect to HTTP Proxy. Your proxy may be misconfigured or offline."
"vgui_HTMLCopyUrl"	"Kopeeri lehekülje URL"
"[english]vgui_HTMLCopyUrl"	"Copy Page URL"
"vgui_HTMLCopyLink"	"Kopeeri lingi aadress"
"[english]vgui_HTMLCopyLink"	"Copy Link Address"
"vgui_HTMLSearchMatch"	"%findactive% / %findcount%"
"[english]vgui_HTMLSearchMatch"	"%findactive% of %findcount%"
"vgui_HTMLSearchThisPage"	"Otsi sellelt lehelt"
"[english]vgui_HTMLSearchThisPage"	"Search this page"
"vgui_choosedirectoryname"	"Vali kataloogi nimi"
"[english]vgui_choosedirectoryname"	"Choose directory name"
"TextEntry_CopyAllToClipboard"	"Kopeeri kogu tekst lõikelauale"
"[english]TextEntry_CopyAllToClipboard"	"Copy all text to clipboard"
}
}
